12
11
111111111118
130010100018
121010101010
101012111210
101g00000010
101112111110
100010000010
121210111210
111020202010
100211101110
111111111110