18
11
111111111111111111
130202002002002001
100202002002002221
122202002222220001
100002002020020001
100012222020220001
122010002020020001
100011111111111111
100220020020020001
100020020020020001
111111111111111111