5
5
11111
13001
10121
101e1
11111