13
11
1111111000000
1310201000000
1010101000000
1010101111111
10101h20200g6
1010111011111
1010101010000
1010101210000
1010101010000
10201f2010000
1111111100000