8
9
11111118
13100e18
10101010
10101010
10121110
10200010
12111210
10100f10
11111110