11
11
11111111111
13001010001
11101010201
10200211221
10210000001
10111221101
10001000001
12221011121
10102020201
10022020141
11111111111