7
9
1111111
1010001
1012001
1012001
1022221
1020001
1222001
1002001
1111111