12
11
111111111118
130010100e18
121010101010
101212111210
101000000g10
101112111110
10001f000010
121210111210
111020202010
100211101110
111111111110