10
10
1111111111
1300000001
1010010001
1011012101
1020112101
1102100121
1100110101
1020012101
1011002001
1111111111