5
6
11111
13001
10121
10101
101f1
11161