11
11
11111111111
13001010001
12101010101
10101211121
10100000001
10111121111
10001000001
12121011121
11102020201
10021010111
11111111111