7
11
1110111
1310161
10101e1
1010101
1010121
1010101
1010101
10101h1
1011121
10200f1
1111111