13
11
1111111000000
1310201000000
1010101000000
1010101110000
10101h2010000
1010111011111
1010101010000
1010101211111
10101000200g6
10201f1111111
1111111000000