12
11
111111111118
130010100018
121010101010
101012111210
1010g0000010
101112111110
1e0010000010
121210111210
111020202010
100211101110
111111111110