12
11
111111111118
131e10102018
1010101f1010
101010101010
101012101010
102010101010
101010211010
101020101010
101010101010
102010102010
111111111110