11
11
11111111111
13001010001
12101010101
10100211121
10110000001
10111121101
10001000001
12121011121
10102020201
10021020101
11111111111