8
9
11111118
13101018
10102010
10112110
10000000
10121110
10100010
10100010
11111110