9
10
111111111
131000001
101011111
10111f2g1
101110101
102010101
011010101
001016101
001e20001
000111110