8
10
111
13100161
101101e1
10201101
01101101
00101101
00102001
00111121
00000101
00000101
00000161