11
11
11111111111
10002020001
12202020201
10201011221
10210000101
10111221101
10001010001
12221011121
10102020201
10020120101
11111111111