5
5
11111
13001
10121
101f1
11111