8
9
11111118
131f2018
10101010
10101010
10101210
10161010
12211010
11000e10
00111110