7
9
1111111
1310001
1010101
1010101
1012111
1020001
1211211
1010001
1111111