8
9
11111118
13100018
10101010
10101010
10121110
10200010
12111210
10600f10
11111110