8
9
11111118
131f0018
10101210
10101010
10121010
10101e10
12101210
10201610
11111110